имя: имени 
главный: Главный главную главным главном Главная главными Главным главные главный главных 
базин: Базин 
личный: личную личными Личный 
наслаждаться: Наслаждайтесь наслаждаюсь 
азиатский: Азиатской азиатской 
зенит: Зенит Зенита Зените 
папа: Папа 
возглавить: возглавил возглавить возглавили 
паралимпийский: Паралимпийские 
пожить: поживем 
рияд: Рияд 
возможный: возможным возможный возможном возможной 
гребля: Гребля 
коридор: коридорах 
креативный: креативный креативен 
тренировка: тренировкам тренировке тренировки 
волейбол: волейбол Волейбол волейболу 
дух: духе дух 
конькобежец: конькобежцы конькобежцев конькобежец Конькобежцы 
огромный: огромное огромнейших огромная огромным 
повернуться: повернуться 
фигурный: Фигурное фигурного фигурное фигурном фигурному 
фехтование: Фехтование 
александр: Александра Александр 
кто: кого Кого кому кем 
новый: новых новом новыми Новая новый новую Новый нового новой 
работать: работаешь работаем работали работал 
итог: итоги итогу Итог итогам итоге Итоги итог итогом 
скандал: скандал 
ребята: ребята ребятами ребят ребятам Ребята 
доллар: долларов 
россиянин: россиян россиянин россиянина россиянином Россиянин 
пальмас: Пальмас 
певица: певица певицей 
презентация: Презентация 
обзор: Обзор обзоры обзор 
вулверхэмптон: Вулверхэмптон 
пройти: прошел прошла пройдут пройдет 
красный: Красная Красно красно 
сессия: сессия 
шуметь: Шуми 
уокер: Уокер 
тяжёлый: тяжелая Тяжелая тяжелый тяжелого тяжелее 
продолжаться: продолжаются продолжалась продолжался 
хабаровск: Хабаровск 
цена: цену цена 
продвигаться: продвигаться 
хоккей: хоккею хоккея Хоккей хоккей 
исаев: Исаев Исаева 
труненков: Труненков 
диета: диеты Диеты 
прислать: пришли 
рада: Рада рады 
платформа: платформе платформа 
запланировать: запланировано запланирована 
искренний: искренний 
блогер: блогер Блогер блогером блогера 
сезон: сезону сезонов сезон сезонах сезоне сезона сезоном 
гора: горах горе гор 
взять: взяла Возьми Взять взяли возьмите взял возьмет взять 
творчество: творчеством творчество 
питер: Питере 
сыграть: сыграли сыграла сыграют сыграет сыграл 
тарба: Тарба 
месяц: месяца месяцев 
серия: Серия серию Серии серии 
любительский: Любительский 
пепа: Пепа 
джурасик: Джурасик 
сюжет: сюжета 
барс: Барсу Барсом Барса Барс 
тренер: тренерам тренера тренером Тренер тренер тренеров Тренеры 
третий: третья Третий третьим третьего третью третий третьем Третьими 
стать: стало стала Стало стать став Стали стали стал станут 
уроженец: уроженцем 
продлить: продлит продлено продлил продлить продлила 
тренироваться: тренироваться Тренироваться тренируется 
выигрывать: выигрывает выигрывать 
занимать: занимать занимают занимает занимал 
боксёр: боксер боксера боксеров боксером 
джош: Джош 
информация: информацию информация информации 
зрелость: зрелость 
мина: Мина 
теодосичем: Теодосичем 
поступить: поступила 
завоевать: завоевал завоевали завоевала завоевать 
писать: пишет пишут пишите 
мэттьюса: Мэттьюса 
двенадцатый: двенадцатая 
смешанный: смешанную Смешанная 
навылет: навылет 
сельта: Сельта 
метод: Метод Метода 
холодный: холодная 
мальцев: Мальцев 
равновесие: равновесие 
ответственность: ответственность 
закончиться: закончились закончится 
возвращение: возвращение Возвращение возвращении возвращением возвращения 
борец: борцов борцу борцам борец 
сюрприз: сюрприз 
эксклюзивный: Эксклюзивное 
бронзовый: бронзовым бронзовые Бронзовые бронзовую 
витязь: Витязя Витязь 
ливерпуль: Ливерпуль Ливерпулю 
победить: победить победило победила победит победили победил 
разговаривать: разговаривать разговариваем 
исполнительный: Исполнительный 
соотношение: соотношению 
либо: либо Либо 
арена: Арены арену Арена арене Арене 
надеяться: надеется Надеюсь надеюсь 
какой: Какую Какие каким какие какую какое 
лантратов: Лантратов 
ежевечерний: Ежевечерний 
патрон: патронов 
порядок: Порядок порядок 
минута: минуте минутах минута минуты минут 
километр: километров 
организм: организм 
прогноз: Прогноз прогнозы Прогнозы прогноз 
также: Также также 
коэффициент: коэффициент коэффициентом 
футбольный: футбольных футбольной Футбольный 
черноморец: Черноморец 
ас: АСА 
создатель: создатели 
кататься: катался кататься катаемся 
ключевой: Ключевые ключевую ключевыми 
масса: массу масс 
обвинить: обвинила обвинили 
ракетка: ракетка ракетку 
батыршина: Батыршина 
бреут: Бреут 
тамбов: Тамбов 
сильный: сильнейшие сильные силен сильная сильнее 
атлантический: Атлантический 
соревнование: соревнованиях Соревнование соревнование соревнований соревнованиям 
секунда: секунд секунды 
последний: последние последняя последней последних последнего Последний последнее последним Последние последнем 
ненадлежащий: ненадлежащем 
набрать: набрав набрал набрала 
дисквалификация: дисквалификацию 
состав: составы составе состав 
система: Систему 
поединок: поединка поединке поединком поединок поединков поединку 
дело: делу делом дел дело деле Дело 
ожидаться: ожидается 
жирный: жирные жирными жирных 
стартовать: стартует стартовать 
бокс: бокс бокса Бокс боксу 
пятикратный: пятикратный 
жарковатый: жарковато 
этикетка: этикетке 
женщина: женщин Женщины женщины 
разбежаться: разбежался 
регулярный: регулярного регулярный Регулярный регулярном 
сообщаться: Сообщается сообщается 
голевой: голевую голевая 
сегодняшний: сегодняшнее 
медведь: Медведь 
рукавицын: Рукавицын 
быстрый: быстрая быстрый быстрее 
слайд: слайде 
промоушене: промоушене 
спорт: спорта спорте СПОРТА спорту спорт Спорт 
делить: делят 
дзюба: Дзюба 
хоффенхайм: Хоффенхайм 
гость: гостями гостем гости гостях гостей 
доверие: доверие 
следить: Следить следите следить следим Следите 
обойти: обойдя обошел обошла 
первый: Первого Первый первым первой Первая первую первые первая Первой первыми первый первого первом 
ущерб: ущерба 
спринтерский: спринтерский 
выставить: выставлен 
оценить: оценили оценил оценила оценен 
отпустить: отпустил 
умар: Умара 
смениться: сменилась 
лотерея: лотерею лотерея 
турнир: турнира турниров турниру Турниры Турнир турнире турниры турнир турнирах 
кг: кг 
микроб: микробов 
везде: везде 
сила: сил силу силы силам 
нога: ногах ногу ногой 
ферстаппен: Ферстаппен 
мама: Маме Мама мама 
такой: таким таком Таким такому Такое такие такого такая такое таких 
федерация: федерация федерации федерациям Федерация федерацию Федерации 
леван: Леван 
рейтинг: Рейтинги рейтинг рейтинге Рейтинг рейтинги 
никулин: Никулин 
трофимец: Трофимец 
новичок: новички новичка 
честь: честь 
уровень: уровню уровень уровнем уровне уровня 
спартак: Спартаком Спартаке Спартака 
зарплата: зарплата зарплатах 
съесть: съел 
кадр: кадры кадром Кадр 
янькова: Янькова 
ключ: ключе 
трижды: трижды 
француз: француз француза французом 
минаур: Минаур 
игрок: игроки игроков Игрок игрок игрока игрокам Игрока игроком Игроком 
превратиться: превратилась 
ступак: Ступак 
галиев: Галиев 
йоксимович: Йоксимович 
трава: траве 
николича: Николича 
слой: слоев 
совладать: совладать 
вратарь: Вратари Вратарь 
иордания: Иордания 
молодёжный: Молодежные молодежном Молодежный 
марафон: марафоне марафона марафон 
новость: новостей Новости новости новость 
маковый: Маковей 
отметить: Отметим отметили отметил отметила 
лига: Лиги Лигам лиг Лига лигах лигу Лиге лигой лиги лига лиге 
гонка: гонку гонка гонками Гонка Гонку гонках гонкам гонки гонке гонок 
самый: Самые Самый самых самая самое самый самые самым 
легендарный: легендарной Легендарный 
мочь: мог можем могло Можете могу можете могут 
пакет: пакет 
букмекер: букмекеров 
лишь: лишь 
барселона: Барселоне Барселона Барселону Барселоны Барселоной 
бутырский: Бутырская 
вопрос: вопросом Вопрос вопросе Вопросы вопрос 
пока: Пока пока 
аккуратный: аккуратным 
джуд: Джуд 
мадридец: мадридцев 
повторить: повторят повторить повторил повторила 
вилла: Виллой Вилла 
спортсменка: спортсменки Спортсменки Спортсменка спортсменка 
шеффилд: Шеффилд 
объяснить: объяснил 
никабагамаеве: Никабагамаеве 
город: городе 
являться: являлся является 
билет: билет 
факт: фактов факт 
приговор: приговор приговора приговоре 
край: крае края 
чарльз: Чарльз 
легенда: Легенда легенда 
отвечать: Отвечает отвечать 
четверной: четверными четверные 
менелл: Менелл 
егор: Егора Егор 
продуцироваться: продуцируются 
галлям: Галлямов 
вращение: вращения вращении 
посмотреть: посмотрел посмотрим посмотреть 
реал: Реала Реалом Реал Реале Реалу 
укрепление: укрепление 
женский: женскую Женское Женский Женская женском 
каролина: Каролина 
регламент: регламента регламент 
говорить: говорили говорить говорю говорят говорила говоря говорит говорил 
салернитану: Салернитану 
диктовать: диктовать 
жуан: Жуана 
обратный: Обратная обратный 
клуб: клубе клубу клуба клуб клубом Клубам Клуб клубов клубах 
болезнь: болезни болезнью 
фримпонг: Фримпонг 
ветеран: ветераны ветеранов 
полузащитник: полузащитника Полузащитник полузащитнику полузащитник 
выиграть: выиграли выиграла выиграл выиграть Выиграть 
команда: команде команды Команда Команды командами команда команду команд командой 
прохоркин: Прохоркин 
офф: офф 
компенсация: компенсации 
сосредоточить: сосредоточены 
пролезть: пролез 
непонятно: Непонятно 
салернитана: Салернитана 
специалист: специалиста специалист 
объявить: объявила объявили объявило объявил 
авария: аварии 
трансфер: трансферы трансфере трансферах Трансферы трансфера 
баскетболистка: баскетболистке Баскетболистки 
группа: группе Группа 
дмитрий: Дмитрия Дмитрий 
включать: включать включают 
отказать: отказал отказали отказав 
выразить: выразил выразила 
россиянка: Россиянка россиянку 
обновить: обновленная Обновленный обновленный 
становиться: становилась становится 
незаменимый: незаменимая 
бобслей: бобслея бобслей бобслею Бобслей бобслеем 
арсенал: Арсеналом Арсенале Арсенал 
показать: показал покажут показана показала показать показали покажет 
иностранец: иностранцы иностранцев 
кристиан: Кристиана Кристиан 
назвать: назвал названы назвали назвала Назовите Названы 
лорьян: Лорьян 
смотреть: смотреть Смотреть смотрит смотря 
полный: полное полном полная полную полный 
остаться: остался осталась Осталось останусь осталось останется 
ранее: Ранее ранее 
он: нему 
именно: именно 
мария: Мария 
стример: Стример стример 
хуан: Хуан 
попрощаться: попрощались попрощалась попрощался 
отбойник: отбойник 
чилуэлл: Чилуэлл 
разговор: Разговор разговоре 
старший: старшим старше 
экономно: экономно 
закрыть: закрыл закроет 
болельщик: Болельщики болельщики болельщикам болельщика болельщиков 
охдуд: Охдуд 
пригласить: пригласила пригласил пригласили 
денис: Денис 
уходить: уходил уходит 
ана: Ана 
новогодний: Новогодняя 
анатолиевич: Анатольевне 
гомес: Гомеса 
число: числе число числа 
человек: людей Люди людям люди человеки человек человека 
виннипег: Виннипег 
речь: речи речь 
лейпциг: Лейпциг Лейпцигом 
процесс: процессы процесс 
маркус: Маркус 
вернуться: вернется вернулась вернуться вернулся 
найденышев: Найденышев 
димитров: Димитров 
летний: летний летнем летнего летняя летние летнюю Летние летним 
медаль: медаль медалей медалью 
термобелья: термобелья 
периодический: периодические 
хайденхайм: Хайденхайм 
идеальный: идеальной идеальные 
учёный: ученые Ученые 
стерлинг: Стерлинга Стерлинг 
француженка: Француженки 
тупой: тупая 
форма: ФОРМЫ формы форме форму 
полуфинал: Полуфинал полуфинале полуфинал 
дубль: дублю Дубли дубли дубль Дубль 
единоборство: единоборства Единоборства единоборствах единоборствам 
совет: Советы Советов 
поменять: поменять 
лондон: Лондон Лондона Лондоне 
медальный: медальный Медальный 
арбитражный: арбитражный 
отдел: отдела Отдел 
дембель: Дембеле 
международный: международный международную международных международные Международное Международный Международной 
лыжник: лыжниками Лыжник лыжник лыжники 
чемпионат: чемпионате Чемпионата чемпионата Чемпионат чемпионатом чемпионаты чемпионат чемпионатах 
мышь: мышах 
конец: концов конце конца конец 
пример: примере примеров примером примеры 
египтянин: Египтянин 
дисквалифицировать: дисквалифицировало Дисквалифицированная дисквалифицирована дисквалифицировали дисквалифицированная дисквалифицировал 
понимать: понимаете понимает понимал понимаю понимают 
ласа: Лас 
вроде: вроде 
продолжение: продолжения продолжение 
урал: Урала Урал 
сей: сих 
составлять: составлять 
хороший: хорошая лучшим хорошем Лучший хорошие лучших хорошую Хорошая хороший хорошим лучшего лучшему лучший Лучшие хорошего лучшее 
биатлонист: биатлонистами Биатлонист 
реабилитация: реабилитацию 
вольный: вольная 
субъект: субъектов 
мы: нами Нами нам 
психологический: психологической психологическая психологическими 
большой: Большого большого 
уход: ухода уход уходу уходе 
алджамейна: Алджамейна 
треск: треск 
дэвис: Дэвисом Дэвиса 
мозг: мозга 
сотрудник: сотрудников 
румыния: Румынию Румынии Румыния 
довольный: Довольный довольна Довольны 
сериал: сериала сериалы сериал Сериал Сериалы 
минус: минусов 
франция: Франции Франция 
трансляция: трансляций Трансляцию трансляции трансляцию трансляция 
золотой: Золотые Золотого золотые золотых золотую 
матч: матч матчем Матчи Матча матчах матчей матча матче Матч матчи 
жк: ЖК 
попробовать: попробовать 
детройт: Детройте Детройта Детройт 
барнаул: Барнаула Барнаул 
источник: Источник источника 
перебороть: переборол 
грансир: Грансир 
быстров: Быстров 
расположиться: расположилась 
полтинник: полтиннике полтинник 
андрей: Андрея Андрей 
выплатить: выплатила выплатил 
сделать: сделать сделает сделал сделано сделаны 
важно: Важно важно 
усман: Усман 
очередной: очередную 
зарабатывать: зарабатывают 
леверкузене: Леверкузене 
принести: принести принес принесли 
соперник: соперники соперников соперника соперником соперник 
шайба: шайб шайба шайбы шайбами шайбой 
переходить: переходить переходит 
соотечественница: соотечественницу 
наслать: нашли 
пауза: паузу пауза 
бой: бою Бой боем бои бой боя боями 
пётр: Петр Петра 
бабушка: бабушек бабушка 
сын: сыну сына 
скончаться: Скончался 
задача: Задача задачи Задачи задачу 
олимпийский: Олимпийских олимпийском олимпийские олимпийское Олимпийская олимпийский 
турнирный: турнирную турнирной Турнирная турнирные 
сомневаться: сомневаться 
корона: корона 
побег: побег побега 
класс: Класс класс 
вероятный: вероятный 
получить: получила получить получи получил получили получат 
равенство: равенстве 
жаловаться: жалуются 
калифорнийский: калифорнийском 
аннулировать: аннулированы 
другой: другие другую Другое Другие других 
покупка: покупки 
полностью: полностью 
некоторый: некоторым 
негодовать: негодовал 
этьен: Этьен 
проходить: проходят проходит проходили проходить 
обязанность: обязанностях 
сбор: сборах сбор сбора сбором сборов сборе 
европа: Европе Европы Европа 
испанский: испанском испанской 
репортаж: Репортаж 
золото: Золото золота золото 
панарин: Панарин 
велоспорт: Велоспорт 
игра: игры Играх играх игру игре Игра Игр игра Игры игр игрой 
хотеть: хотели хотим Хотел хотят хочу хочет Хочу хотел хотела 
кай: Кай 
статистика: Статистика статистику статистика 
встречать: встречает встречают 
решить: решил решили решить 
продолжать: продолжает 
карлос: Карлосу Карлос Карлоса 
ирак: Ирака 
перспектива: перспективе 
потерпеть: потерпел потерпела 
фаворит: фавориты фаворитами фаворитом фаворит 
финальный: финальной финальном 
российский: Российская Российские российская Российский российских российский российским российского российском Российскому 
казарцев: Казарцев 
прийти: придет пришло 
профессия: Профессия 
участвовать: участвовал участвуйте участвовать 
боец: бойца Боец бойцов боец бойцы Бойцы бойцом 
премьера: премьера 
мфл: МФЛ 
сербия: Сербии 
енисей: Енисея Енисей 
краснодар: Краснодара Краснодар Краснодаре Краснодаром 
казаться: кажется 
испания: Испания Испании 
поступать: поступало поступали 
производитель: производителя 
лыжный: Лыжное Лыжные лыжное лыжных лыжному лыжном 
четыре: четыре четырьмя четырех 
большунов: Большунов Большунову 
честность: честности 
севилья: Севилья 
шувалов: Шувалов 
тоттенхэм: Тоттенхэм 
произвольный: Произвольная произвольными произвольной произвольная произвольный произвольную произвольных 
москва: Москва Москвы Москву Москве 
ман: Ман 
тело: тело теле тела 
фигуристка: фигуристок фигуристка фигуристки Фигуристка 
титул: титулы титулов титул 
мелькнуть: мелькнула 
торторелла: Торторелла 
батут: Батут 
онемение: онемение 
стартанули: стартанули 
школа: школе 
моуринью: Моуринью 
чан: Чанов 
эй: Эй 
захаров: Захаров Захарова 
никто: Никто никто никому 
назначение: назначение 
свой: своему свое свой своем своих своего своими свои Свой 
мажор: Мажора 
ницца: Ницца Ниццу 
представлять: представляющие представляли 
центр: центра центр центре 
доротея: Доротея 
зубков: Зубков 
вничью: вничью 
приводить: приводит 
звезда: звездой звезды звезд ЗВЕЗДОЙ Звезды 
официальный: официальном официального официальный 
ротенберга: Ротенберга 
кислота: кислоты кислотами кислот 
качество: качество качестве 
десятый: десятым десятых 
интересоваться: интересовался интересуется 
работа: работы работу работа 
арис: Арис 
возраст: возраст возраста возрасте 
внутренний: внутреннее внутренняя внутреннего 
потерять: потеряла потерял 
талант: талант талантом 
копия: копией 
высокий: высшего высоким высокий высокого Высокий высокие высоком 
задний: заднем 
вряд: Вряд 
момент: моментов моментом моменты момента момент 
явиться: явилось 
петербуржец: Петербуржцы 
бриджертоны: Бриджертоны 
металлург: Металлург Металлургу 
недостаточно: недостаточно 
эксперт: экспертов Эксперты эксперты 
ждать: Ждете ждал Ждать 
гимн: гимн 
крюков: Крюков 
характер: Характер характер 
грузия: Грузии 
южнокорейский: южнокорейского 
гави: Гави 
суд: Суд суда суд судом суде 
аугсбург: Аугсбург 
принять: принять принял примет примут приняло принято 
отставка: отставку отставке 
различный: различными 
неймар: Неймар 
росберга: Росберга 
телеканал: телеканал телеканале телеканала 
основный: основная Основная основную 
соболезнование: соболезнования 
наиболее: наиболее 
насру: Насру 
формула: Формула Формулу Формулой 
стиль: Стиль стиля стилем стиле стиль Стиля 
заключительный: заключительным заключительный заключительного 
свентек: Свентек 
спастись: спасся 
образ: образом 
спринт: спринте спринта Спринт спринт 
оливейра: Оливейра 
возможно: возможно Возможно 
точка: точки 
завтра: Завтра завтра 
футбол: футбол футболу футболе Футбол 
автор: Автор автором Авторы авторы 
мужик: мужики 
конёк: коньках Коньки 
айван: Айван 
тюмень: Тюмени Тюмень 
крутой: Крутые 
заключить: заключит 
календарь: Календарь календарь 
спарринг: спарринге 
грузинский: грузинских Грузинский грузинский 
памплона: Памплона 
нурмагомед: Нурмагомедов 
задобрить: задобрил 
никитин: Никитин 
судиться: судиться 
спринтер: спринтеров 
подняться: поднялся поднялась 
определённый: определенную определенная 
тест: тесты Тесты 
заслужить: Заслуженный заслужил 
технический: техническим техническими техническая 
баскетбол: Баскетбол баскетболе баскетбола баскетбол баскетболу 
впереди: впереди 
скобликова: Скобликова 
медведев: Медведева Медведев 
отец: отца 
экшен: экшен 
обновиться: обновится 
дыхание: дыхании 
непростой: непростую 
мода: Мода 
март: марте марта 
сбавлять: сбавляют 
сибирь: Сибирь Сибири 
флорида: Флорида 
лидер: Лидером лидер Лидеры лидеры 
ветрозащита: ветрозащитой 
клон: клон 
экономиться: экономился 
выбыть: выбыл 
вновь: вновь 
возглавлять: возглавляет 
заболевание: заболевание 
гомельский: Гомельский 
фильм: Фильмы фильма 
результативный: результативные результативную результативными результативны результативный результативных 
мрачно: мрачно 
эльвира: Эльвира 
политический: политическое политическую политическим 
двигаться: двигается 
венгрия: Венгрии 
ответ: ответы ответ 
несмотря: несмотря 
выручить: выручить 
плавание: Плавание плавание 
нанести: нанес 
страдать: страдающих 
оператор: оператор 
детство: детстве 
бирюков: Бирюкова 
бриндамор: Бриндамор 
скриншот: скриншоты 
метр: метров 
кусочек: кусочек кусочка 
мощный: мощное мощный 
исторический: исторического 
надевать: надевает 
убивать: убивающие 
перерыв: перерыве перерыва 
румынский: Румынская 
вяльбе: Вяльбе 
сен: сен Сен 
гол: гола голами голов голу 
катание: катанию катании катания катание 
выступать: выступал выступают выступать выступает выступала выступали 
мера: мере 
втб: ВТБ 
садулаеву: Садулаеву 
защитник: защитник защитники Защитник защитника защитнику 
около: около 
заниматься: занимался занималась заниматься занимается 
исследование: исследований 
отразить: отразив 
квята: Квята 
ла: Ла ла 
стрельба: Стрельба стрельбы 
двукратный: Двукратный двукратный 
маккинноном: Маккинноном 
знак: знаком 
лаптев: Лаптев 
симптом: симптомам 
драфт: драфта 
пользоваться: пользоваться 
превыше: превыше 
семь: семь 
конфетка: конфетками 
основание: оснований 
начаться: начнется начнутся 
буэнос: Буэнос 
бельгиец: бельгиец 
рассул: Рассул 
вынесение: вынесения 
чемпион: чемпионов чемпион Чемпиона чемпионом Чемпион чемпионами чемпиона 
опасаться: опасается опасаться 
отличный: отличную 
стартовый: стартовую стартовом стартовые 
туйнов: Туйнов 
таблица: Таблицы таблица таблицу таблице таблицы Таблица 
фатех: Фатехом 
янченков: Янченков 
адмирал: Адмирал 
особенно: Особенно особенно 
диабет: диабетом диабет 
лч: ЛЧ 
завершение: завершении завершения 
современный: современной Современное 
джорджевич: Джорджевич 
волга: Волга 
открытие: открытие 
челиос: Челиос 
иттифак: Иттифак 
плохой: хуже плох плохих 
тройка: тройке 
мордасов: Мордасов 
омск: Омск 
мена: мен 
порадовать: порадовало порадует 
этап: этап этапе этапа этапах 
драться: драться дрался 
наградить: наградил 
насколько: насколько Насколько 
настроение: настроении 
коврик: коврик 
вид: видов виды виде 
видеть: видит видим видите вижу 
девять: девять Девять 
назад: назад 
мэр: мэр 
думать: Думал думает Думаю думаешь думали думал думаю 
хотеться: Хотелось хотелось 
алекс: Алекс 
помочь: помог помогут помогли поможет 
леонтьев: Леонтьев 
мороз: морозом морозу мороза морозе 
харитонов: Харитоновым 
рынок: рынок 
август: августа 
свердловский: Свердловская 
конгресс: конгресс Конгресс конгресса 
белоруссия: Белоруссия Белоруссией 
премьер: Премьер премьер 
посоветовать: посоветовал 
нереализованный: Нереализованный 
чувствовать: чувствовал чувствовала чувствовали чувствует 
южный: Южного Южный Южной 
катар: Катаре Катару 
журналистика: журналистика 
четвёртый: четвертым четвертое 
ссылка: ссылке 
олимпиада: Олимпиадах Олимпиады Олимпиада Олимпиаде Олимпиаду 
спокойный: спокоен 
зритель: зрителям зрителя зрителей 
норвегия: Норвегии Норвегия 
оформить: Оформить оформил оформили оформить 
ант: Анте 
содержаться: содержатся 
вирер: Вирер 
октябрь: октября 
нация: наций 
граовац: Граовац 
арестовать: арестовать арестовала арестуют арестован 
тренерский: тренерского тренерскую тренерском 
служба: служба 
век: веке 
париж: Париже Париж 
подобрать: подберем Подберем подобрать 
провоцировать: провоцируют провоцирует 
победитель: победители победитель Победителем победителя Победитель победителем 
самбист: самбист 
максимально: максимально 
результат: результата результаты результат результатах Результаты результатами результатом результатов 
двоеборец: двоеборцы двоеборцам двоеборец Двоеборца 
болеть: болит болеть болеешь болеет 
сало: Сал Салах 
освистывать: освистывать 
вода: воду 
евро: Евро евро 
арбитр: арбитр арбитром 
неинтересный: неинтересно 
подробность: подробностей 
статья: Статьи статьи 
бахрейн: Бахрейне 
срыв: Срывы 
вашингтон: Вашингтона Вашингтон 
раунд: раунде раунд 
заключение: заключения заключении 
вершина: вершину 
ньюкасл: Ньюкасл 
кожа: кожа кожи 
брат: брату братья 
ветлугин: Ветлугин 
уступить: уступила уступил уступят 
вольфсвинкела: Вольфсвинкела 
спартакиада: спартакиаде Спартакиада спартакиада Спартакиаду Спартакиаде 
однозначно: однозначно 
бенеил: Бенеил 
рассмотрение: рассмотрение 
россия: Россия России Россией Россию 
канзас: Канзас 
мотивация: мотивация Мотивация 
задержание: задержания 
обсуждать: обсуждаемые обсуждали обсуждать 
автограф: Автограф 
войти: вошли Войти вошел 
мировой: мирового мировом 
тактический: тактической 
прокуратура: прокуратурой прокуратура Прокуратура 
смеяться: смеются Смеется 
северсталь: Северсталь 
дать: даст Дана Дай дали 
считать: считаю считать Считаете считают считает Считаю 
бердыев: Бердыев 
вальтер: Вальтера 
переместиться: переместилась 
топ: Топ топ 
намерение: намерении 
русский: русском русского русский Русские русским Русская 
место: Место места местами место месте 
прокат: проката прокат прокаты прокатом 
физика: физикой 
майкл: Майкл 
врезаться: врезался 
подача: подачи 
блатта: Блатта 
австралийский: Австралийский 
шипулина: Шипулина 
кан: Кан 
оправдать: оправдал 
бактериальный: бактериальными 
отдавать: отдают 
отметиться: отметились отметился отметившись 
видеообзор: видеообзор Видеообзор 
миллер: Миллер 
прямой: прямом прямую прямая Прямая Прямую 
штутгарт: Штутгарт Штутгарта 
нарижный: Нарижный 
председатель: председателем 
уроженка: уроженки 
пэлас: Пэлас 
ребёнок: детях ребенок Дети детям 
рсфср: РСФСР 
называть: называть 
попасть: попасть попал 
нарушение: нарушениями нарушение 
получаться: получается 
шово: Шово 
чий: Чими 
очко: очка очко очков 
спортсмен: спортсмен Спортсмены спортсменов спортсменам спортсменом спортсмены 
аналитик: Аналитики аналитиков 
здоровый: здоровыми 
выбраться: выбраться 
подписаться: подписаться Подписаться 
данилов: Данилов 
немножко: немножко 
опрос: Опросы 
готовиться: Готовимся Готовился готовился готовится 
казахстан: Казахстана Казахстан 
поставить: поставлю поставленные поставь поставить 
опубликовать: опубликовал Опубликован опубликовано опубликовали 
пекин: Пекине Пекин 
забастовка: забастовки 
пробиться: пробился пробиться пробились 
живьём: живьем 
выяснить: выяснили 
филадельфия: Филадельфия 
редактор: редактор 
алания: Алания 
контрабанда: контрабанду 
знать: знать знала знаем знаю знает знал 
поддержка: поддержкой поддержку 
заявление: заявлении заявление 
дальнейший: дальнейшие дальнейшими 
сборная: сборной Сборная сборную сборная 
заявить: заявил заявили заявила 
предыдущий: Предыдущий предыдущих предыдущем 
увидеть: увидите увидел увидим увидела 
второй: второго вторым втором вторых Вторым Вторая вторую 
шалька: Шальке 
паралич: паралич 
биатлон: биатлоне Биатлон биатлоном биатлона биатлону 
битва: битве 
транслировать: транслирует 
одиночный: Одиночный одиночном 
находиться: Находящийся находится находящимся 
аспект: аспекте аспектами 
пересесть: пересел 
сеть: сетях сети 
встреча: встреча встречу Встреча встреч встречи встрече 
руководство: руководству руководством Руководство руководство 
пойнт: пойнта пойнтов 
дивизион: дивизионами дивизион 
кёрлингист: керлингистов 
располагаться: располагается располагаются 
зимний: зимних Зимний зимний зимняя Зимние Зимняя 
передача: передачи передачами передаче передач передача передачу 
томь: Томь 
соревноваться: соревновались 
новгород: Новгород Новгорода 
связать: связано связаны 
фрайбург: Фрайбург 
фернандес: Фернандес 
сет: сетах сете 
территория: территории 
колобкову: Колобкову 
всякий: всякий 
луис: Луиса Луис 
представляться: представляется 
авг: авг 
одержать: одержал одержало одержали одержала одержать 
взаимоотношение: взаимоотношения 
эрнандес: Эрнандесом Эрнандес 
воротить: воротит 
конструктор: конструкторов 
сон: Сон 
сахар: сахара сахар 
украинка: украинку 
мемфис: Мемфис 
довбик: Довбик 
моделировать: моделировать 
избегать: избегает 
неоднократно: неоднократно 
мадс: Мадс 
недостаток: недостаток 
день: день дня дни День 
принимать: принимать принимала 
рубль: рублей 
продюсер: продюсер продюсером 
столичный: Столичный 
мать: мать матери 
узнать: узнал 
руль: рулем 
значит: значит 
руководитель: руководителем Руководителя 
борнмут: Борнмут Борнмутом 
польза: пользу Польза 
который: который которого которая которую которых которые 
лишить: лишил лишили 
профессиональный: профессиональном профессиональных Профессиональный 
глобальный: глобальные 
афк: АФК 
республика: республике 
лос: Лос 
умереть: умерла умер 
ивуар: Ивуар 
свежий: свежую 
польский: польская 
иван: Ивана Иван 
народный: Народный 
мартинес: Мартинеса Мартинес 
тот: та тому тех те 
баскетболист: баскетболиста баскетболист 
ивича: Ивича 
узнавать: узнаю Узнавать 
запретить: запрещенное запретить 
старт: старт старта старты старту стартах стартом старте 
морозный: морозный морозном 
массово: массово 
казань: Казани Казань 
появляться: появляются 
дижон: Дижон 
разобрать: разобранная 
футболист: футболистов Футболист футболист футболисты футболиста футболистам 
кошмар: кошмар 
участник: участники участником Участник участника участников 
выходить: выходит выходить выходил выходя выходи выходишь 
счастливый: счастливы 
сразу: сразу 
копылов: Копыловым Копылов 
гирасси: Гирасси 
вулверхэмптону: Вулверхэмптону 
граница: границу границ 
позиция: позиция позицию позиций 
свищев: Свищев 
час: часа час часов 
казаков: Казакова 
иметь: имеет имею 
провести: провело проведет провел проведут провести провели 
сокращение: сокращения 
джонатан: Джонатан 
голубой: голубые голубых 
бразилец: бразильца 
даллас: Даллас 
ксения: Ксения 
ответный: ответный ответном 
важный: важный важных важнее Важны 
продолжить: продолжит продолжить 
активность: Активность 
мегаспорт: Мегаспорт 
постепенно: Постепенно 
поздравлять: поздравляют 
план: плане планами планах планы 
антон: Антона Антон 
ольга: Ольга 
овечкин: Овечкин 
итальянец: итальянца Итальянец 
ванесса: Ванесса 
сильно: сильно 
ришар: Ришар 
происходить: происходит происходил происходящего 
противостояние: противостояния противостояние противостояниях 
точный: Точный 
соболев: Соболевым Соболев 
еврокубках: еврокубках 
допуск: допуска Допуск 
весь: Вся весь всем 
горный: Горные 
восток: Востока Востоке 
теннис: теннис теннисом тенниса теннисе Теннис 
елизавета: Елизавета 
нападение: нападения нападение 
проверка: Проверка 
милан: Милан 
хозяин: хозяев 
анна: Анны Анна 
понравиться: понравилось понравились 
ведьмак: Ведьмак Ведьмака 
млс: МЛС 
бпла: БПЛА 
нужно: нужно Нужно 
обыгрывать: обыгрывал обыгрывать обыгрывает 
смочь: смогла Смог смогу сможет смог смогли 
савелий: Савелий 
уволить: уволил 
хетафе: Хетафе 
жить: живем 
ошибка: ошибку Ошибка ошибок 
конкуренция: конкуренции 
коста: Коста 
виза: виз визами визу 
пакистанский: пакистанская 
арест: арестом 
фил: Фил 
появиться: появилась Появились появился появится Появилось 
пообещать: пообещал 
хоккеист: хоккеистов хоккеист 
милошем: Милошем 
суббота: суббота субботу 
переход: переходе перехода переход переходов переходу 
ди: Ди 
выступить: выступить выступит выступил выступят 
опасный: опасен 
узбекистан: Узбекистана 
бохум: Бохум 
прощальный: прощальный 
интернет: Интернет интернет 
преподнести: преподнести 
парламентский: Парламентские 
актив: активе 
пятёрка: пятерка 
президент: Президент президентом президент президента 
проигрывать: проигрывает проигрываешь 
эмоционально: эмоционально 
тысяча: тысяч тысячи 
короткий: короткими Короткая короткую короткой короткая короткие 
зарубежный: зарубежном Зарубежные зарубежную 
выпустить: выпустит выпустить 
карабах: Карабах 
остальной: Остальные остальные 
лондонский: Лондонский лондонский 
недвижимость: недвижимости 
премия: Премия 
бубакар: Бубакар 
поражать: поражает 
обозреватель: Обозреватель 
младший: младшим младший 
белый: Бело бело белый 
настоящий: настоящему настоящим 
порезаться: Порезалась порезалась 
серьёзный: серьезном серьезного 
ярослав: Ярослав 
инсайдер: инсайдер Инсайдер 
оно: оно 
женя: Женя 
даша: Даша 
отыграться: отыграться 
корреспондент: Корреспондент корреспондентом корреспонденту корреспондента 
ливач: Ливач 
болид: болид 
настолько: настолько 
философия: философией философия философии 
организатор: организаторов 
владимирский: Владимирской 
сказать: скажет Сказала сказано сказать сказали скажу сказал Сказали сказала 
сменить: сменил 
настать: настанет 
фергюсон: Фергюсон 
дополнительно: дополнительно 
болезненный: болезненным 
исключить: исключить 
физический: физическую 
тяжело: Тяжело тяжело 
завершить: завершил завершат завершит завершить 
игнашевич: Игнашевич 
положительный: положительных положительные положительное 
шейх: Шейхи 
общий: общих общей Общий общем 
обстрелять: обстреляли 
гимнастика: гимнастика 
девин: Девин 
фриц: Фриц 
красиков: Красиков 
садулаев: Садулаев 
головин: Головин Головину Головина 
забросить: забросили забросить заброшенными 
материал: материалы материал Материалы материале 
доминге: Доминге 
лёгкость: легкостью 
общаться: общаемся 
глушаков: Глушаковым 
мост: моста 
ахмат: Ахмат 
косторная: Косторная 
обыграть: обыграв обыграть обыграла обыграли обыграло обыграл 
вести: вела ведут ведем 
предел: пределами предел 
губерниеве: Губерниеве 
больно: больно 
подписка: подписку подписке 
молодой: молодая молод молодых 
вчера: вчера Вчера 
подчеркнуть: подчеркнули 
впечатление: впечатление впечатлениями 
должный: должен должны должна 
жизнь: жизни жизнь жизнью Жизнь ЖИЗНЬ 
майка: майку 
уефа: УЕФА 
карен: Карен 
побить: побил 
снова: снова 
наш: нашей наших нашем нашу Наша наш нашего 
зефельде: Зефельде 
спортивный: спортивного спортивную Спортивный Спортивное Спортивная спортивный спортивных 
использовать: использовали Используй 
нигериец: нигериец 
соперница: соперницам 
добиваться: добивается 
приговорить: приговорил приговорен 
дармштадт: Дармштадт 
пропустить: пропустит пропустил 
самара: Самары 
уверенный: уверен 
каменеть: Каменев 
воронков: Воронков 
досрочно: досрочно 
нижний: Нижнего Нижний 
круто: круто 
уоткинса: Уоткинса 
истечь: истечет 
анатолий: Анатолия Анатолий 
синий: синие Сине сине синих 
коростелев: Коростелев 
составить: составят составили составил составить 
стремиться: стремился стремимся стремится 
запад: Западе 
алла: Аллу 
американец: американцем американец американца Американец 
страна: страны странах стране страну 
шанс: шансы шансов шансах шансом 
равняться: равняется 
хын: Хын 
представитель: представитель Представитель Представители представители 
пара: пару пары пар паре 
беллингема: Беллингема 
концовка: концовке 
неподобающий: неподобающем 
пробовать: пробовать Пробует 
лицо: лицом 
кляйндинст: Кляйндинст 
совместный: совместный совместные 
капитан: капитан капитанов 
власть: Власти власть 
право: права правах Прав прав право 
навсегда: навсегда 
снять: снимет сняла 
питерский: Питерский 
киоск: киоски 
интерес: интересе интерес 
чесноков: Чесноков 
аннулирование: аннулирования 
планировать: планировал планирует планируешь 
вица: вице Вице 
сторона: сторону 
константин: Константин 
точно: Точно точно 
дружить: Дружил 
голосование: голосованием 
хави: Хави 
недооценивать: недооценивает 
настраиваться: настраиваемся 
редакция: Редакция редакции 
девятый: девятое девятым 
разбирать: разбирать 
украинец: Украинец 
песня: песню 
возмещение: возмещения 
достаточно: Достаточно достаточно 
сесть: сесть сел 
невероятный: невероятен невероятные 
трудовой: трудовое 
адрес: адрес 
жёстко: жестко 
тюремный: тюремного 
вольфсбургом: Вольфсбургом 
рассказать: рассказал расскажет рассказала Расскажи рассказали 
освобождение: освобождения освобождении 
поехать: поехав поедут 
спортзал: спортзалы 
пресс: Пресс пресс 
ледовый: ледовом 
напасть: напав 
пора: пор Пора 
запас: запасе 
повредить: поврежденном 
манчестер: Манчестер Манчестере 
исламабад: Исламабаде 
боксёрский: боксерский боксерскому боксерском 
себя: собой 
екатерина: Екатерина 
гаджиев: Гаджиев 
гражданство: гражданства 
брать: брала берут 
густо: Густо 
сборный: сборных 
канал: канала канале 
взлёт: взлеты 
отказ: отказ отказов отказе 
глава: Главу главы главу Глава 
менять: менять меняем 
фрибет: фрибет 
барелла: Барелла 
комплект: комплекта комплект 
доха: Доха 
обсуждение: обсуждении 
предречь: предрекли 
завтрашний: завтрашний 
пронин: Пронин 
казахстанский: казахстанская 
холодно: холодно Холодно 
пистолет: пистолета 
сервис: сервисов сервис 
сафиуллин: Сафиуллин 
тренировочный: тренировочного 
трасса: Трассы трассе трассы 
трактор: Трактор 
лёд: льда льду лед 
согласиться: согласился 
татарстан: Татарстана 
баюшкин: Баюшкин 
светлый: светлое 
налёт: налетах 
анонсировать: анонсировал анонсировали 
дисаси: Дисаси 
еженедельный: еженедельном 
лестер: Лестер 
будущее: Будущее будущего будущее будущем 
альберт: Альберт 
финал: Финал финала Финалы финале финал 
конференция: конференциями конференция конференций 
навести: наведут 
определиться: Определились 
педру: Педру 
штыркова: Штыркова 
таракан: Тараканов 
дрозд: Дрозд 
скачать: Скачать 
легионер: легионеров 
целый: целую целый Целый 
вк: ВК 
универсиада: Универсиада 
шипачев: Шипачев 
радовать: радует 
отправиться: отправились отправился 
таун: Таун 
хэмилтон: Хэмилтон Хэмилтону Хэмилтона 
санный: санному 
рад: Рад рад 
нету: Нету 
переслать: перешли 
белорусский: Белорусская белорусскими 
халеп: Халеп 
воробьёв: Воробьев 
фонкор: ФОНКОР 
подкачаться: подкачался 
исход: исхода 
альварес: Альварес 
минск: Минск Минске 
шахтёр: Шахтер 
вонг: Вонг 
видеокарта: видеокарт 
сак: Сака 
брайтон: Брайтон Брайтона Брайтоном 
вокал: вокал 
бедро: бедра 
допустить: допустят допустила допустил 
отсутствие: отсутствии Отсутствие 
прыжок: Прыжки прыжков 
видеотрансляция: Видеотрансляция видеотрансляция 
безопасность: безопасностью безопасности 
делать: делают делать делает 
илия: Илия 
гуляев: Гуляев 
видеотрансляции: видеотрансляции 
дортмундский: Дортмундская 
состояние: состоянии состояние 
вывод: выводу выводы 
макумбу: Макумбу 
заезд: заездов 
всухую: всухую 
контент: контент 
бороться: боролись 
созреть: созрела 
услышать: услышали 
уимблдон: Уимблдон 
анджелес: Анджелес 
саудовский: Саудовская Саудовской 
интересный: интереснее интересная 
патч: патч 
инцидент: инциденте 
иммунитет: иммунитет 
чемпионшип: Чемпионшип 
реклама: рекламы Реклама 
практика: практику практике 
показывать: показывать показывают 
эстафета: эстафете эстафета эстафету Эстафета 
слух: слухах слухи 
выступление: выступлений выступление выступлении 
мерседес: Мерседес 
почувствовать: почувствовал Почувствовал 
зарубеж: зарубеж 
карда: карда кард 
продукт: продуктах продукты продукт 
мозеса: Мозеса 
пбл: ПБЛ 
успешно: успешно 
подписываться: Подписывайтесь подписывайтесь 
узбекский: узбекскому 
рекламодатель: Рекламодатель 
простой: проще 
провал: Провал провал 
перейра: Перейра 
роберт: Робертом 
приехать: приедет приехал приехали 
малышко: Малышко 
деннис: Деннис 
преддверие: преддверии 
концепция: концепция 
киножурналист: Киножурналист 
фиорентина: Фиорентина 
условно: условно 
подмосковный: Подмосковный 
италия: Италии Италия 
кондратюк: Кондратюка 
категория: категорию категорий 
сверхкатание: сверхкатание 
год: годам Год год годы году года лет годах 
раз: раза разу 
курс: курсе 
домашний: домашнем домашнего Домашний 
видеообзоры: видеообзоры 
заинтересованный: заинтересован 
попросить: попросить 
екатеринбург: Екатеринбурге 
врач: Врач Врачи врачи врач 
испанец: испанца испанец 
спать: спят 
кормить: кормить 
руслан: Руслан 
отобрать: отобрал 
пошуметь: пошуметь 
лётный: летные 
лайв: лайв 
жертва: жертве 
лично: лично 
рекорд: рекорд рекордом 
смысл: смысле смысла 
поиск: Поиск Поиски поиске поисков 
отрицать: отрицает 
карпов: Карпов 
виссам: Виссам 
разгромить: разгромил разгромить 
пояс: пояс 
ван: ван 
лёгкий: легче Легкая 
зачёт: зачете зачет Зачет 
гамбург: Гамбург 
уникальный: Уникальные 
спуск: спуск спуска спуске 
читатель: читателей 
геймер: геймеров геймер 
документально: документально 
двоеборье: двоеборью 
фёдор: Федор Федором 
обморок: обморок 
уважение: уважении уважением 
мокнуть: МОК 
лидировать: лидировать лидируют лидирует 
лондонец: лондонцы Лондонцы лондонцев 
неделя: Неделя недели 
опенда: Опенда 
небольшой: небольшая 
кёрлинг: керлингу керлинга Керлинг 
юниорский: Юниорская 
авангард: Авангарде Авангарда Авангард 
отправить: Отправлю отправлен 
ювентус: Ювентусе Ювентус 
отбор: отбор отборе 
ожидать: ожидать ожидала 
шалганов: Шалганов 
клопп: Клопп 
минимум: минимум 
ян: Яна Ян 
дарья: Дарью Дарья 
дэвид: Дэвида Дэвид 
вальдесу: Вальдесу 
ранний: раньше 
начало: начала начале 
заплатить: заплатит 
карасев: Карасев 
видеотрансляцию: видеотрансляцию Видеотрансляцию 
воронеж: Воронеже 
эвертоном: Эвертоном 
йоханнес: Йоханнесе Йоханнес 
воскресенский: Воскресенская 
лопес: Лопес 
слуцкий: Слуцкого 
отмечать: отмечает 
форвард: форвард форварда Форвард 
штамп: штампы 
фулхэм: Фулхэм 
вадим: Вадим 
перехватить: перехватить 
зачахнуть: зачах 
мой: мое мои моем 
великобритания: Великобритании 
финишный: Финишная 
карьера: карьере карьеру карьера карьеры 
подписать: подписала подписал подписать 
вернуть: вернуть 
ганнибал: Ганнибал 
продожается: продожается 
увольнение: увольнении Увольнение 
встретиться: встретится встретятся встретилось встретились 
волгарь: Волгарь 
отдых: отдых 
австрия: Австрии 
тимофей: Тимофея 
поверх: поверх 
поддерживать: поддерживает поддерживают Поддерживаю 
болгария: Болгария 
фитнес: фитнес 
упасть: упала упал 
икра: Икрам 
туда: туда 
бэй: Бэй 
буш: Буше 
случай: случай случаях случае 
отъезд: отъезда 
параллельный: параллельном параллельных 
сиэтл: Сиэтл 
разругаться: разругались 
самойлов: Самойлов 
цель: цель целей целях целью 
далёкий: Дальше дальше 
прекрасный: прекрасный 
кровь: крови 
мма: ММА 
покинуть: покинул покинет 
булла: Булл 
итальянский: итальянскому Итальянская 
сайт: сайта сайт сайте 
увеличиться: увеличился 
теодосича: Теодосича 
путин: Путина 
лу: Лу 
шар: Шара 
требовать: требует 
уметь: уметь умею умеет 
мохаммад: Мохаммад 
стрингер: стрингер 
умный: умная 
реализовать: реализовал реализовала реализовать 
записать: записав записали 
текущий: текущая 
воевода: Воевода 
слабый: слабую 
четвёрка: четверок 
ссср: СССР 
удивиться: удивился 
вариант: Вариант вариант варианты 
отметка: отметку 
большинство: большинство 
стихия: стихию 
период: период периода 
деяна: Деяна 
контракт: контрактов контракте контракта Контракт контракт 
медик: медики 
ледниковый: Ледниковый 
скоро: скоро Скоро 
нэшвилл: Нэшвилл 
фунт: фунта 
обидно: Обидно обидно 
бомбардир: бомбардиров бомбардиром Бомбардиры 
гавр: Гавр Гавра 
аэропорт: аэропорта 
баттл: баттл 
дима: Дима 
оставаться: остается Оставалось 
гранатовый: гранатовые 
кишечный: кишечными 
пищевой: пищевых 
толпа: толпа толпе 
позволить: позволил 
бобслеистка: бобслеистка 
белорус: белорусов Белорусам 
выход: выход выходу выхода 
догнать: догнал 
бк: БК 
выдвинуть: выдвинутые 
подвести: подвел подвести Подвела 
позвать: Позови 
каннабис: каннабисом 
сообщество: сообществах 
кризис: кризисе 
петербург: Петербург Петербурга Петербурге 
призёр: призером призер 
приступить: приступил 
куньлунь: Куньлунем 
киберфутбол: Киберфутбол 
резерв: резервы 
поблагодарить: поблагодарила поблагодарил 
десна: деснами 
против: против 
начать: начали начал 
самолёт: Самолет 
мелехин: Мелехин 
ака: Аке 
роль: роль роли 
касаткин: Касаткину 
спич: спич 
брага: Брага 
правильно: Правильно правильно 
фигурист: Фигурист фигуриста фигуристов Фигуристы фигурист 
отстранение: Отстранение отстранение 
задеть: задел 
фройнд: Фройнд 
раздел: Раздел разделе 
январь: января январе 
тм: ТМ 
одежда: одежды 
лакросс: лакросс 
бавария: Бавария Баварии Баварию 
грабить: грабила 
проехать: проехал 
стадион: стадионе стадионом Стадионы 
действовать: действует 
хан: Хана Ханом 
явно: явно 
всемирный: Всемирная 
челябинск: Челябинске Челябинск 
бирмингемцев: бирмингемцев 
девушка: девушек девушка 
владимир: Владимира Владимир 
великий: величайшим 
иго: Ига 
тухеле: Тухеле 
дариуш: Дариуш 
учитывать: Учитывая 
всероссийский: Всероссийская Всероссийской 
япония: Япония Японии 
набоков: Набоков 
критиковать: критиковал критикует 
беляев: Беляев 
михаил: Михаил 
забрать: заберет забрал забрать 
садковый: Садкова 
немка: немки 
болгарин: болгарина 
уверить: Уверены Уверена уверены 
произвести: произвел 
причёска: прической 
кассьерра: Кассьерра 
завешил: завешил 
больший: большая 
провокация: провокаций 
перенести: перенес 
полезность: полезности 
прошлый: прошлой прошлом прошлый 
забить: забили забить забил забьют 
король: Короля короля 
прервать: прервать 
вес: весе вес 
лишний: лишнего 
далее: далее 
селить: Сельте 
награда: награды награду наград 
уткин: Уткин 
сдержать: Сдержать 
расписание: Расписание расписание 
алиев: Алиев Алиева 
деньга: Деньги деньги 
белгородский: Белгородской 
критерий: критериям 
рассылка: рассылка 
стихотворный: стихотворное 
шаг: шаг шагом 
выжать: Выжал 
хард: хард 
рио: Рио 
гандбол: Гандбол 
патриотизм: патриотизма патриотизм 
летие: летие летия 
мерсисайдцев: мерсисайдцев 
кардиолог: Кардиолог 
степанов: Степанова 
кубок: Кубке кубка Кубка кубки Кубок кубком 
внедрить: внедрить 
акинфеев: Акинфеев 
плюс: плюсов 
идти: идут иду шел идет идти 
победный: победную 
псж: ПСЖ 
влечь: влечет 
голос: голос 
кержаков: Кержакова Кержаков 
далер: Далер 
воронцевич: Воронцевич 
тема: тема 
командный: командном командный командные 
махачев: Махачев 
австралиец: австралиец 
лев: Лев 
московский: московского Московская Московское московскому московскую Московской московский Московскую московское московском 
агент: агентами агента 
верона: Верона 
предлагать: предлагают предлагает 
реалистичный: реалистичную 
испытывать: испытывают 
даниэль: Даниэль 
логинов: Логинове Логиновым Логинов 
интересовать: интересует 
опуститься: опустился 
силва: Силва 
сказка: сказку 
банда: Банда 
махачкалинский: махачкалинское 
приз: приз 
грузин: грузина грузин 
поражение: поражение поражения поражений 
пункт: пункт 
протяжка: протяжек 
два: Две две двумя 
вызов: вызова 
пит: пит 
почему: Почему почему 
шеф: Шеф 
низость: низость 
боком: боком 
невилла: Невилла 
сокол: Сокол 
бекхэм: Бекхэм 
подкаст: подкаст 
сэ: СЭ 
однако: Однако однако 
добрый: добрый 
преодолеть: преодолели преодолел преодолело 
трек: трек Трек трека 
прежний: прежнему прежний 
фонд: фонд 
сантос: Сантос 
глушенков: Глушенков 
швеция: Швеция Швеции 
персонал: персонал 
тюрьма: тюрьмы тюрьме 
похороны: похорон 
магомед: Магомеда Магомед 
пропасть: пропал Пропавший 
серебряный: Серебряные серебряным 
добрать: добрать 
шахматы: Шахматы 
депай: Депай 
миннеаполисе: Миннеаполисе 
косвенный: косвенным 
конкакаф: КОНКАКАФ 
тропический: тропический 
предложение: предложений предложение 
рен: РЕН 
хотспур: Хотспур 
красавчик: красавчик 
тяга: тягу 
лететь: летел 
мбаппе: Мбаппе 
соглашение: соглашение соглашению 
ламек: Ламек 
употребление: употребления 
оказывать: оказывают 
наладить: наладили 
соулслайк: соулслайк 
неуместно: Неуместно 
победа: побед Победа победой победу победы победе победа 
торрент: торренты 
василиса: Василис 
конькобежка: конькобежка Конькобежка 
включая: включая 
выполнить: выполнены 
привыкнуть: привык 
просить: Прошу 
планета: планеты 
леонид: Леонида 
равноправие: равноправия 
алексей: Алексея Алексей 
домогательство: домогательства домогательствах 
сухожилие: сухожилии 
стрикленд: Стрикленд 
янник: Янник 
три: трех 
балтика: Балтике Балтика 
серебро: серебро Серебро серебре серебра 
искать: искать ищет 
бесплатный: Бесплатная 
ошибаться: ошибался 
консоль: консолях 
янина: Янина 
тизер: тизер 
судимость: судимостью 
оригинал: оригинала 
немец: Немец 
фристайл: Фристайл 
чернов: Чернов 
примерно: примерно 
набирать: набирал набирает набирать 
промчаться: промчались 
быть: будем Будем будут буду 
дос: дос 
говориться: говорится 
судейство: судейство судействе 
теоретический: теоретическими 
чисто: чисто 
позволять: позволяет 
сосьедад: Сосьедад 
пародонтита: пародонтита 
дождь: Дождь 
нейрон: нейронов 
сербский: сербского 
воспринимать: воспринимать 
пресса: прессе 
легков: Легков 
надеть: надел 
сонный: сонный 
эрлинга: Эрлинга 
насыщенный: насыщенную 
слеп: Слепов 
кузьмичёв: Кузьмичев 
режиссёр: режиссер режиссером 
искусство: искусство 
подумать: подумал подумать 
гранада: Гранада 
хк: ХК 
сергей: Сергей Сергею 
кадис: Кадиса Кадис 
тёплый: теплый теплую 
деметриус: Деметриус 
выбрать: Выбери 
дотянуть: дотянуть 
парень: парень парня парнем 
экслюзивное: Экслюзивное 
профессионал: Профессионалы профессионалом 
посев: посев посева 
пост: поста пост 
болонья: Болонья 
проведение: проведения проведении 
кинопоиск: Кинопоиск 
автомобилист: Автомобилист 
переговоры: переговоры переговорах переговоров 
стратегия: стратегией 
отказаться: отказаться отказался 
отличиться: отличившись отличились отличился 
нижегордцев: нижегордцев 
будимир: Будимир Будимира 
правильный: правильным 
голенкова: Голенкова 
подготовка: подготовке подготовка подготовки 
читать: Читать читайте Читайте 
двухместный: Двухместный 
суперкубок: Суперкубок Суперкубка 
окт: окт 
программа: программами программы программу программе программ программа 
максенс: Максенс 
канадец: Канадец Канадцы 
ценз: ценз 
исполнение: исполнении исполнения 
срок: сроках Срок 
ты: тебе Тебе 
аризона: Аризона Аризону Аризоны 
прибегать: прибегал 
представительница: представительницы представительницу 
рпл: РПЛ 
австралия: Австралии Австралия 
бобслеисты: Бобслеисты 
реакция: реакция Реакция реакции 
суметь: сумели 
невозможно: невозможно 
шлем: шлема шлем 
абсолютно: абсолютно 
время: время времени Время 
нейросети: Нейросети 
цыплаков: Цыплаков 
поучиться: поучиться 
нидерланды: Нидерландов Нидерланды 
клубный: Клубный клубном 
одинаковый: одинаковые одинаковый 
развитие: развитием развитию 
восемь: Восемь восемь восьми 
этихад: Этихад 
компонент: компонентами 
елена: Елену Елена 
экипаж: экипаж Экипаж 
козлов: Козлова Козлов 
лайкин: Лайкин 
ставка: Ставка ставку ставок ставка 
юбилей: юбилей 
фактор: фактором 
едва: едва 
уралмаш: Уралмаш 
дементьев: Дементьев 
юдаков: Юдаков 
шинник: Шинник Шинника 
рубрика: рубрики 
затяжной: затяжные 
тепло: тепло 
сексуальный: сексуальных сексуальными 
нокаут: нокаутом нокаут 
весовой: весовая 
жуков: Жукову 
агентство: агентство агентства 
неаполь: Неаполь 
победительница: победительница победительницами победительницей 
дойти: дошла 
кстати: Кстати 
перематывать: перематываю 
губерний: Губерниев 
руно: Руну 
история: История историю 
тик: тик 
сетевой: сетевое 
критик: критиков 
поднять: поднять 
данные: данным 
кикбоксинг: Кикбоксинг 
падение: падения 
мур: Мур 
экспресс: Экспресс Экспресса 
грибковый: грибковыми 
этот: этими этих 
глупо: глупо 
фернандеш: Фернандеш 
касаться: касается 
ряд: ряд ряда 
костылев: Костылев 
обгон: обгоны 
сумма: сумму сумма сумме 
бить: бить бьет 
валентина: Валентина 
расследование: расследование 
непросто: непросто 
синнер: Синнер 
юнайтед: Юнайтед 
мяч: мячей мячу мячом мяча 
поверить: поверил 
понаблюдать: понаблюдать 
полезный: полезными полезную 
создать: создали 
фотография: фотографию 
добавить: добавил ДОБАВИТЬ добавила 
свободный: Свободный свободным свободные 
улица: улице 
рацион: рацион 
раскрыться: раскрыться 
хватать: хватает 
парусный: Парусный 
игровой: игровые игрового игровую 
жжение: жжение 
мэттьюс: Мэттьюс 
давать: дает дают давай Давай 
актуальный: актуальном 
мохамед: Мохамед 
астана: Астана Астаной 
обеспечить: обеспечить 
область: область области 
никакой: Никаких никакого 
участие: участия участие участии 
предоставить: предоставит 
научиться: научились 
эфир: эфир Эфир эфире 
драйв: драйва Драйв 
выздоровление: выздоровлении 
черышев: Черышева Черышев 
публиковать: Публикуем 
тренировать: Тренировать тренировать 
танец: Танцы танцах танец 
довести: довели доведена 
марселино: Марселино 
кряду: кряду 
непристойный: непристойным непристойные 
устать: устала устать 
газетный: Газетный 
алькарас: Алькарас 
четвертьфинал: четвертьфинала четвертьфинале четвертьфинал 
мадрид: Мадрид 
отлечь: отлегло 
кузяевым: Кузяевым 
финиш: финиш финише 
коновалов: Коновалов 
кошелев: Кошелев 
равно: равно 
микст: микст микста 
миранчуке: Миранчуке 
ростислав: Ростислав 
разряд: разряде разряд 
ланс: Ланс 
вещь: вещей 
пять: пять Пять пяти 
мир: мир мире миры мира 
валенсия: Валенсии Валенсия 
клинсманн: Клинсманн 
скромность: скромность 
получиться: получится получилось 
балл: баллов баллам балла баллами 
заслуга: заслуга 
тухеля: Тухеля 
решать: решать 
дата: дата даты 
блин: Блин 
удивить: удивит удивили 
польша: Польша 
валиев: Валиеву 
римский: римской римская 
внутри: Внутри внутри 
требоваться: требуются 
ритм: ритм 
закончить: закончить закончил 
алексис: Алексис 
делрэй: Делрэй 
доказать: доказал доказана 
поменяться: поменяться 
освоение: освоению 
придумать: придумает 
глаз: глаза 
случиться: случилось 
аргентинец: аргентинец 
монца: Монца 
сегунда: Сегунда 
прошлое: прошлым прошлого 
виктор: Виктора Виктор 
миранчука: Миранчука 
наполоть: Наполи 
выезд: выезде 
бестемьянова: Бестемьянова 
замулы: Замулы 
мх: Мх 
добавка: добавок добавкой 
магомедкерим: Магомедкеримов 
предполагать: предполагаемой 
повод: поводу 
платонов: Платонова 
рецепт: Рецепты 
контакт: Контакты 
селекция: селекция 
безусловный: безусловный 
кайседо: Кайседо 
скучный: скучном 
содержание: содержанием содержания 
божуар: Божуар 
проблема: проблемой Проблема проблема проблемами 
ноттингем: Ноттингем 
кевин: Кевин Кевина 
замена: замену 
предложить: предложил предложено 
дом: дома 
подкладка: подкладку 
мытищи: Мытищи 
кремонезе: Кремонезе 
возмутиться: возмутились 
жорж: Жорже 
фабиан: Фабиана 
анонс: анонс 
случаться: случаются 
кротон: Кротоне 
тур: туров туре тура 
кинг: Кинг 
комар: Комаров 
пряник: прянике 
штрафной: штрафных 
семья: семье семью 
эпизод: эпизод 
игнат: Игнат 
адий: Адиев 
прокомментировать: прокомментировал прокомментировала прокомментировали 
хорватский: хорватский 
персонаж: персонажем персонажами 
знаток: Знатоки 
пляжный: Пляжный 
конькобежный: Конькобежный 
воспитывать: воспитываю 
куница: Куница 
молодец: молодец 
художник: Художник 
немного: Немного немного 
блокада: блокады 
зима: Зима зимы зима 
русски: русски 
улыбка: улыбкой 
поцелуй: поцелуи 
ночь: ночам ночь 
вещество: вещество 
англия: Англии Англия 
бойцовский: Бойцовский 
май: мая 
шорты: Шорты Шорт 
фосфолипиды: фосфолипиды 
далеко: далеко 
химки: Химках Химок Химки 
процедура: процедур 
голый: голом 
овечка: овечку 
возобновление: возобновления 
мендес: Мендес 
помнить: помню 
пбк: ПБК 
выдавать: выдает 
вавассори: Вавассори 
ханна: Ханна 
лихачёв: Лихачев 
шалун: Шалунов 
ярославль: Ярославле Ярославль 
погодный: погодные 
роджер: Роджер 
флаг: флаг флагом 
лука: Лука лука 
постоянно: постоянно 
расположение: расположение 
сдаваться: сдаемся 
ахнуть: Ахли 
доступный: доступна доступен доступны 
могильный: Могильный 
переживать: переживал переживаю 
девочка: девочка 
тянуть: тянет 
голова: голове голова 
красава: красава 
монреаль: Монреаль 
одолеть: одолеет 
кроме: Кроме 
постановочный: постановочный 
нормально: нормально 
чимаев: Чимаев 
щетинин: Щетинин 
янв: янв 
мхл: МХЛ 
исключительный: Исключительный 
радость: радости 
португалец: Португалец португальца 
рождение: рождения 
смородская: Смородская 
вместе: вместе Вместе 
квят: Квят 
крыло: Крылья 
фев: фев 
хавронина: Хавронина 
гаске: Гаске 
дзен: Дзен 
борьба: борьбу борьбы Борьба борьбе 
чернышов: Чернышову 
баэна: Баэна 
катарский: катарский 
относиться: относились относимся 
отыграть: отыграл 
открыть: откроет открыл 
улучшать: улучшают 
бразильский: бразильский 
кузнецов: Кузнецов Кузнецова Кузнецовым 
корян: Корян 
мастерство: мастерство 
порт: Порту 
фраза: фразу 
бен: Бен 
минский: Минское минское 
магнитогорск: Магнитогорске 
юрист: юристов 
ленинградец: Ленинградец 
казанцев: казанцев 
дайджест: дайджест 
амир: Амиру 
ляказетт: Ляказетт 
орать: орали 
побеждать: побеждает побеждала 
товарищеский: Товарищеские товарищеский товарищеском Товарищеский 
дацюка: Дацюка 
невыдача: невыдачей 
аршак: Аршак 
кучер: Кучеров 
штат: штат 
мешок: мешки 
полуфиналист: полуфиналистом 
виторией: Виторией 
масло: маслах 
ворота: воротам 
обменять: обменяют 
кинохитов: кинохитов 
неожиданный: Неожиданный 
порой: Порой 
производительность: производительность 
выходной: выходных 
запуск: запуска 
июнь: июне июня 
вылезать: вылезал 
смешно: смешно 
тульский: тульском 
предатель: предателем предатель 
весна: Весна 
ученик: ученика Ученик ученику 
пригодиться: пригодился 
железо: железу 
тасс: ТАСС 
надпись: надпись 
дубай: Дубае 
спросить: спросили 
успех: успех успеха Успех 
крайне: крайне 
водный: Водное 
директор: директор 
вячеслав: Вячеслав 
сложный: сложный 
галина: Галина 
европейский: европейский 
степан: Степан 
селина: Селина 
регулярно: регулярно 
аль: Аль 
квалификация: Квалификация квалификации 
релиз: релиз Релиз 
бухаев: Бухаев 
стираться: стирается 
платный: платный 
пятница: пятницу пятницам 
бросок: броски Броски бросков 
задержать: задержали задержан 
оттава: Оттава Оттавы 
сопровождаться: сопровождается 
воспитанник: воспитанник 
счёт: счете Счет счету счет счетом 
обойтись: обошлось обойдется 
базаров: Базарова 
относить: относят 
цитировать: цитирует 
реймс: Реймс 
идея: идею 
водить: водить 
неприемлемый: неприемлемо 
двойной: двойные 
де: Де де 
норвежский: Норвежские 
ехать: едет едут 
таджикистан: Таджикистана 
единственный: единственный Единственный 
продление: продление 
фк: ФК 
парижанин: парижан Парижане 
упражняться: упражнялся 
хайп: хайп 
протяжение: протяжении 
измениться: изменилась 
частый: частое 
сэм: Сэм 
вывести: вывести 
состояться: Состоялась состоится 
центральный: Центральный центральном 
буллит: буллит буллиты 
дагестан: Дагестана Дагестане 
убрать: Убрала уберут 
подбираться: подбираюсь 
реслинг: Реслинг 
теннисистка: теннисистка Теннисистка 
разминка: разминка разминку 
журналист: журналист журналистами журналистам 
атака: атаки 
удвоить: удвоил 
регион: регионов 
нужный: нужен нужны 
катать: катать 
причина: причинах причину 
акула: акула 
разобраться: разберутся 
правовой: Правовая 
малов: Малов 
спецрепортаж: спецрепортаж 
лунев: Лунев 
розыск: розыск 
германия: Германии Германия 
стадия: стадии 
наполеон: Наполеон 
тейпе: тейпе 
риск: риск 
бичурин: Бичурин 
карточка: карточки 
татьяна: Татьяне Татьяна 
обратить: обратил 
понятно: понятно 
рахимов: Рахимову Рахимова 
текстовый: Текстовую текстовую 
отношение: отношениях отношение 
альмерия: Альмерия 
балашиха: Балашихе Балашиха 
эдмонтон: Эдмонтон 
мартин: Мартин 
вероника: Вероника 
яркий: яркую 
адвокат: адвокаты Адвокат 
америка: Америки Америке 
выложить: выложили 
чилиец: Чилиец 
ленинград: Ленинграда 
кёльн: Кельн 
дружба: Дружба дружбе дружбы 
галицкий: Галицкая 
ски: Ски 
поступление: поступлении 
декабрь: декабря 
эра: Эра 
сад: саду 
нант: Нант 
цюрих: Цюрих 
виноватый: виноват 
реально: Реально реально 
быков: Быков 
нервный: нервное 
сомнение: сомнениях 
выйти: Вышел вышла выйдет выйдут выйти вышел 
рубеж: рубежом 
йорк: Йорке 
вина: вины 
жест: Жесты жестах жестом 
проиграть: проиграла проиграл 
уфимский: Уфимский 
адесанья: Адесанья 
шоураннером: Шоураннером 
поляна: Поляна 
миннесота: Миннесота 
сообщить: сообщили сообщил сообщила 
нефтехимик: Нефтехимике Нефтехимик 
холдинг: холдинга 
включить: включены 
здравомыслящий: Здравомыслящий 
рассудить: рассудит 
подписание: подписании подписание 
подглядывать: Подглядывать 
прописать: прописана 
светлана: Светланы 
шикин: Шикин 
лечче: Лечче 
мозесу: Мозесу 
обязательно: обязательно 
смерть: смертью смерти 
занять: заняла занял заняли 
намного: намного 
конкурентоспособный: конкурентоспособный 
наказание: наказания наказание 
разрывать: разрывает 
ассистент: Ассистенты 
постоянный: постоянной 
скелетон: Скелетон скелетону скелетона 
тимофеев: Тимофеева 
напрячь: напряжет 
уйти: Ушла ушел 
зрение: зрения 
каталонец: каталонцев каталонцы 
вера: Верой 
павел: Павел Павлу 
йонг: Йонг 
достойный: достойный 
ужасный: ужасная 
седьмой: седьмое 
рф: РФ 
подросток: подростка 
ответить: ответила ответил ответить 
оказаться: оказались 
корея: Кореи Корея 
мазилкин: Мазилкин 
бе: Бе 
трое: трое 
определять: определяющим 
собрать: собрали собрать 
куликов: Куликова 
проявить: проявили проявил 
молчаливый: молчаливых 
дистанция: дистанции дистанцию дистанция 
найти: нашла найти 
оптимальный: оптимальная 
итальянка: итальянка 
присоединиться: присоединиться 
минь: Мини мини 
каюм: Каюмов 
разин: Разин 
ежегодный: ежегодный 
иск: иску 
софтбол: Софтбол 
кристал: Кристал 
опередить: опередил 
гражданин: гражданина 
боттас: Боттас 
газета: газету Газету Газета 
февраль: феврале февраля 
бушман: Бушманов 
широкий: широком 
ставить: ставит 
сенсационный: сенсационный 
фёдоров: Федорова 
видеоигра: видеоигр видеоиграми 
проект: проекта 
завершиться: завершилась завершились 
сказаться: сказалось 
драма: драму 
макаров: Макарова 
кипр: Кипра 
вольфсбург: Вольфсбург 
сироткин: Сироткин 
нортуг: Нортуг 
память: памяти память 
лыжница: лыжницы Лыжница 
удаться: удалось 
оскорблять: оскорблять 
саша: Саша Сашей 
первоуральск: Первоуральске 
корт: корты корту 
просто: просто Просто 
откровенничать: откровенничать 
презентовать: презентовал 
постановить: постановил 
спасать: спасает 
обратиться: обратился 
неудобно: неудобно 
хенриксен: Хенриксен 
жамнов: Жамнов 
соцсеть: соцсети Соцсети 
белов: Белов 
отстать: отставшая 
любить: люблю любят Люблю любил 
васильев: Васильев 
илья: Илья 
добровинский: Добровинский 
сегодня: сегодня Сегодня 
юрий: Юрий 
трамплин: трамплина 
назначить: назначен 
квартальнов: Квартальнов 
травма: травму травмах травмы травма 
духаиль: Духаиль 
никита: Никиты Никита 
прощание: прощание 
рамка: рамках 
горожанин: горожанам горожан 
гербулова: Гербулова 
родственник: родственниками 
ваш: вашим 
нож: нож 
джонсон: Джонсон 
пускать: пускают 
допинг: допинг допингом Допинг допинге допинга 
поколение: поколение поколения 
хиляля: Хиляля 
симона: Симона 
чемпионка: чемпионкой чемпионка Чемпионка 
претендовать: претендуют 
шаман: шаманы 
предпоследний: предпоследнее 
невозможный: невозможна 
сафин: Сафин 
тихонов: Тихонова Тихоновым Тихонов 
наркотик: наркотиков 
барыс: Барыс 
миллион: миллионов миллиона миллион 
недовольный: недовольным недоволен 
привести: привел привести 
аравия: Аравия 
фуркад: Фуркад 
стыковой: Стыковые 
повар: повар 
нормальный: нормальный 
регистрация: регистрация 
предпочесть: предпочел 
пилот: Пилоты 
удовольствие: удовольствием 
роберто: Роберто 
переспрашивать: переспрашивал 
статус: статусе 
ресурс: ресурса 
никлас: Никлас 
радостно: радостно 
выжить: Выживут 
прилететь: прилететь 
редко: Редко 
продолжительный: продолжительной 
перепутать: перепутать 
давид: Давид 
замёрзнуть: замерзнем замерз 
неочевидный: неочевидные 
хавбек: хавбек 
жаль: жаль 
существовать: существует 
фофан: Фофана 
претендентка: претендентку 
средний: средний 
роналду: Роналду 
гордиться: Горжусь 
четверо: Четверо 
коннор: Коннор 
расход: расходы 
выделяться: выделяется 
диаш: Диаш 
холанна: Холанна 
строчка: строчку строчке 
кубковый: кубковый 
выглядеть: выглядит выглядела Выглядел 
одерживать: одерживали 
разбор: Разбор 
устроить: устроили устроил 
определить: определены 
шампанское: шампанским 
хуркач: Хуркач 
относительно: относительно 
кнут: кнуте 
нейтральный: нейтральном нейтральная 
математик: математика 
скорее: скорее 
космос: космосе 
спецпроект: Спецпроекты 
толяндию: Толяндию 
подъём: подъеме 
напряжение: напряжения 
кубань: Кубань 
список: список списки 
пятка: Пятка 
индийский: индийским 
остров: остров 
просмотр: просмотра 
классический: классическим классическом 
панагиотакиса: Панагиотакиса 
секретный: секретные 
шестёрка: шестерку 
мвд: МВД 
камил: Камилу 
софья: Софья Софьей 
инфекция: инфекциями 
судья: судьям Судьи 
сёмин: Семин 
упустить: упустили 
таавун: Таавун 
парк: парк 
настроиться: настроиться 
нехватка: Нехватка нехватка 
кара: Кара 
нефтчи: Нефтчи 
четырёхкратный: четырехкратный 
подойти: подойти 
сухость: сухость 
совершенно: совершенно 
пятый: пятую пятое 
теряться: теряется 
дэн: Дэн 
сириля: Сириля 
студия: студия 
конкурент: конкурент конкурентов 
нов: Нове 
энергия: Энергия 
опровергнуть: опроверг 
нота: Нот 
фаткулина: Фаткулина 
красноярск: Красноярске 
дебютировать: дебютировать 
атлетика: Атлетик атлетика 
удивлять: удивлять 
матвей: Матвей 
экстремальный: экстремальная 
кирана: Киран 
чемпионский: Чемпионская чемпионском 
правило: правил 
боб: боб 
диас: Диас 
обидный: обидным 
уэйн: Уэйн 
посвятить: посвятил 
уверять: уверяют 
отточить: отточили 
эксклюзив: Эксклюзив эксклюзива 
рассчитывать: рассчитывает рассчитывать 
ориентация: ориентации 
нокаутировать: нокаутировал нокаутировать 
поджелудочный: поджелудочную 
джон: Джона Джон 
мотивировать: мотивирован 
жир: жирах 
удача: удачи 
гонять: гонять 
выводить: выводят 
защита: Защита 
соревновательный: соревновательный 
ускорить: ускорить 
номер: номер 
штраф: Штраф 
перейти: перейти перешел перейдет 
черта: чертах 
кабинет: кабинет 
ирландец: ирландца 
мочеиспускание: мочеиспускание 
социальный: социальных социальной 
близкий: близок ближайшие близки 
майнц: Майнц Майнца 
соперничество: соперничество 
дебют: дебюте 
собираться: собирается 
количество: количеству количество 
общество: Общество 
готовность: готовность 
кирилл: Кирилл Кирилла 
брест: Брест 
соин: Соин 
ирина: Ирина 
отыгрываться: отыгрываться 
медицинский: медицинскую 
жёсткий: Жесткий 
национальный: национальная национальный Национальной Национальная 
норвежец: норвежца норвежец Норвежец 
иттихад: Иттихад 
восстановиться: восстановилось 
вешить: Вешу 
макар: Макар 
смута: Смуты Смуте Смута 
разборка: разборка 
кямран: Кямран 
обмен: обмене обмен 
праздник: праздника 
евгений: Евгения Евгений 
виталий: Виталий 
покрытие: покрытие 
платформер: Платформер 
проделывать: проделывает 
катерина: Катерина 
трогать: трогать 
отрываться: отрываются 
планка: планку 
кубо: Кубо 
бежать: бежать 
решение: решение решении решения решению решением 
ноунейм: ноунейм 
событие: событиями событие 
водительский: водительских 
играть: играть играем играли играет 
вклад: вклад 
графика: графика 
дарвин: Дарвин 
мохеби: Мохеби 
посредственный: посредственные 
признак: признаки 
пожать: пожала 
вред: вред 
зуб: Зуб 
усталость: усталость 
фора: форой 
анхель: Анхель 
генеральный: генеральным 
эффект: эффект эффекта 
равный: равные 
магнитка: Магнитка 
бадминтон: Бадминтон 
рифма: рифмы 
джонс: Джонс Джонса 
рассчитать: рассчитан 
повышать: повышать 
построить: построена 
альбион: Альбион 
несколько: несколько нескольким 
малыхин: Малыхин 
бурлить: бурлило 
сократить: сокращена 
чума: Чумы 
треш: Треш 
установить: установил 
эртель: Эртель 
бета: Бет 
конкурс: конкурс 
гурьянов: Гурьянов 
сильверстоуне: Сильверстоуне 
яир: Яир 
рекомендовать: Рекомендуемая 
разгромный: разгромную 
албону: Албону 
друг: друг 
взгляд: взгляд взглядов 
представить: представил представлен представила представят 
откатать: откатать 
лутфуллин: Лутфуллин 
фридзон: Фридзон 
безумно: безумно 
парад: параде 
легально: легально 
быстро: быстро 
податься: подался 
галисиец: галисийцев 
очный: очном 
сбегать: сбегала 
фернандеша: Фернандеша 
стойка: стойке 
договориться: договорился 
трагедия: трагедии 
троллинг: троллинг 
отрицательный: отрицательному 
фнл: ФНЛ 
благодаря: благодаря 
пороховница: пороховницах 
неприятный: неприятный 
съёмка: Съемки съемки 
полагать: полагает 
бросаться: бросается 
поздравление: поздравления 
допрашивать: допрашивали 
иванов: Иванов 
хорнер: Хорнер 
патология: патологий 
восстановление: восстановление Восстановление восстановления 
чуждый: чуждо 
внимание: внимание 
вообще: вообще 
ранение: ранения 
влияние: влияние 
олень: олени оленях 
движение: движения 
гимарайнш: Гимарайнш 
удинезе: Удинезе 
петров: Петров 
вписаться: вписаться 
полноценный: полноценным 
полгода: полгода 
желание: желании 
вальекано: Вальекано 
медосмотр: медосмотр 
обращение: обращения обращение 
ноябрь: ноября 
след: следам 
грикспур: Грикспур 
разный: разных 
причастный: причастен 
язык: языке 
пусть: Пусть 
анимация: анимациями 
популярный: Популярное 
наблюдаться: наблюдается 
июн: июн 
сингл: сингл 
скандалист: Скандалист 
отреагировать: отреагировала отреагировал отреагировали 
функционально: Функционально 
еврохоккейтур: Еврохоккейтур 
забросать: забросали 
слышать: слышу 
восторг: восторг 
промежуточный: промежуточное 
получать: получает получал 
марк: Марк 
барыса: Барыса 
мнение: мнением мнению 
убить: убит 
поддержать: поддержал поддержу поддержать 
поскольку: поскольку 
сердечко: сердечко сердечек 
топурия: Топурия 
вместо: вместо 
сидеть: сидел сидит 
письмо: Письмо 
исправиться: исправятся 
кононов: Кононов 
обвинять: обвиняемого 
аренда: аренды аренду 
зелёный: Зеленом 
усик: Усик 
бесплатно: Бесплатно бесплатно 
повестка: повестке 
чехия: Чехия 
оборот: оборотов 
понять: понял поняли понять 
возвращать: возвращать 
мешать: мешает 
яхин: Яхин 
влиять: влияет 
воткнуть: воткнул 
натужный: натужными 
улучшение: улучшения 
седрик: Седрика Седрик 
апоэл: АПОЭЛ 
максим: Максим 
уилл: Уилл 
доля: долей 
продлиться: продлится 
выдать: выдал 
героиня: героиней 
виго: Виго 
целое: целом 
юлия: Юлия 
фотографироваться: фотографироваться 
челлендже: челлендже 
похвалить: похвалил 
каков: Каковы 
наотмашь: наотмашь 
принадлежать: принадлежало 
авторитетно: авторитетно 
готовый: готовы готов 
уилсон: Уилсон 
продлевать: продлевая 
энд: энд 
мск: мск 
известно: известно 
устюгов: Устюгов 
альпина: Альпин 
потасовка: потасовку 
убедить: убеждены 
амстердам: Амстердама 
обвинение: обвинениями обвинению 
соскучиться: соскучились 
роттердам: Роттердаме Роттердам 
первенство: первенстве первенства 
безобразно: безобразно 
норвежка: Норвежки 
осака: Осаку 
павлович: Павлович 
долгий: Долгая долгого 
бояться: боюсь боялся боялись 
пробежать: пробежать пробежали 
это: этим 
ничья: Ничья 
отмечаться: Отмечается 
волкодав: Волкодав 
спрогнозировать: спрогнозировал 
послание: послания 
йип: Йип 
ин: Ин 
полезть: полез 
обладатель: обладателем 
купить: купил 
фоден: Фоден 
кричалка: кричалка 
вперёд: вперед 
отдать: отдал 
ак: Ак 
заменить: заменил заменили заменить 
йонга: Йонга 
абха: Абха 
долгожданный: долгожданный 
вылегжанин: Вылегжанин 
сокамерник: сокамерникам 
брайан: Брайан 
достигнуть: достиг 
лера: Лерой 
бомба: бомбы 
нидерландский: нидерландский нидерландского 
кхл: КХЛ 
гаснуть: Гасли 
упамекано: Упамекано 
подарок: подарками 
волков: Волков 
финишировать: финишировал 
софия: София 
кристофер: Кристофера 
немецкий: немецкой 
многие: многие 
мужской: мужском Мужская 
ор: Ор 
кандидат: кандидатом 
освободиться: освободилось 
бум: бум 
ванкувер: Ванкувер 
пьер: Пьер 
старородящую: старородящую 
олег: Олег 
круг: круга круге 
выпуск: выпуск 
юфл: ЮФЛ 
сургутский: Сургутский 
кокорин: Кокориным 
керлингистка: Керлингистка 
очки: очками 
судить: судить Судили судил судят 
косово: Косова 
питтсбург: Питтсбург 
бывать: бывает 
возобновиться: возобновится 
компания: компании компания 
добиться: добьются 
оленина: Оленин 
неубедительно: неубедительно 
пака: ПАОК 
дебил: дебилом 
нуньес: Нуньес 
завидовать: завидуют 
неожиданно: неожиданно 
комментировать: комментировать 
коламбус: Коламбус 
км: км 
газон: газон 
сбой: сбой 
потеть: потеют потею 
кузяев: Кузяев 
рано: рано 
фулхэмом: Фулхэмом 
скворцов: Скворцове 
брейк: брейк 
внимательно: внимательно 
мичков: Мичков 
зарядить: заряжена 
дворец: дворце 
лезвие: лезвие 
уил: Уил 
артур: Артур 
доминик: Доминик 
сера: Серу 
витесс: Витесс 
факел: Факел 
столетие: столетия 
потенциал: потенциал 
похожий: похожим похожий 
нортуга: Нортуга 
неплохо: неплохо 
впечатлить: впечатлил 
прочный: прочные 
неаполитанец: Неаполитанцы 
свидание: свидания 
мутко: Мутко 
сравнение: сравнению 
засидеться: засиделся 
опережать: опережает 
канада: Канады 
синхронный: Синхронное 
признать: признала признан 
газовик: Газовик 
хейли: Хейли 
сняться: снялась 
короткоцепочечный: короткоцепочечные 
шпана: шпаной 
интересно: интересно 
поэтому: Поэтому поэтому 
уондерерс: Уондерерс 
мессина: Мессина Мессину 
учёт: учетом 
осудить: осудила 
лучича: Лучича 
звон: звон 
западный: Западная 
прогресс: прогресс 
лето: летом лета 
рассматриваться: рассматривалась 
неуважение: неуважение 
боевой: боевом 
тарас: Тарас 
издание: издание 
слово: словах словам 
способность: способность 
например: например Например 
сингапур: Сингапуре 
гасанов: Гасанов 
сам: Сами 
вприпрыжку: вприпрыжку 
раздача: раздачу 
каприз: Капризов 
саутгемптон: Саутгемптон 
сохранить: сохранить 
корейский: корейский 
санкт: Санкт 
лидс: Лидс 
разгром: разгром 
ведущий: Ведущая 
адреналин: адреналин 
евлоев: Евлоев 
артистизм: артистизме 
опция: опция 
забег: забега 
объективно: объективно 
насилие: насилии 
подряд: подряд 
тарасов: Тарасова 
бронза: бронзы бронзу 
оказываться: оказывается 
тц: ТЦ 
украинский: Украинский 
бейсбол: Бейсбол 
гастроэнтеролог: Гастроэнтеролог 
размер: размере 
усиливать: усиливает 
румынка: румынки 
оповещение: оповещения 
семик: Семиков 
шон: Шон 
даниил: Даниила Даниил 
домингуш: Домингуш 
кадровый: кадровые 
нэйтан: Нэйтан 
нанесение: нанесение 
известный: известны 
файзуллаев: Файзуллаев 
даня: Даня 
гараничев: Гараничев 
преображение: преображение 
армеец: армейцев 
артист: артист 
блейдс: Блейдс 
кот: Кот 
ной: ноя 
бразилия: Бразилия 
вставить: вставил 
уоткинс: Уоткинс 
вечер: Вечер 
заказ: заказом 
реальный: реального 
бог: бог 
оренбург: Оренбург 
экипировка: Экипировка 
преимущество: преимущество преимуществом 
локомотив: Локомотива Локомотиве Локомотив 
мюнхен: Мюнхена 
николишин: Николишин 
университет: Университета 
детский: детском 
приобрести: приобрести 
мелбет: Мелбет 
музей: музей 
один: одна одну одном 
маленький: маленький 
череповец: Череповца 
мчм: МЧМ 
востребовать: востребован 
далековато: далековато 
колхоз: колхоза 
поведение: поведение поведении 
глушков: Глушков 
положение: положение Положение 
повышенный: повышенную 
вполне: вполне 
отменить: отменил 
фонбет: ФОНБЕТ 
лёжа: лежа 
ринг: ринге ринг 
рб: РБ 
выстрел: выстрелами 
выдавить: выдавили 
часто: часто 
ноль: ноль 
сложиться: сложилось 
касильяс: Касильяс 
участница: Участницу 
попасться: попался 
фрагмент: фрагмент 
гораздо: гораздо 
махачева: Махачева 
очевидный: очевидным 
шесть: шести 
восьмой: восьмую восьмым 
бактерия: бактериями 
подборка: подборка 
учредитель: Учредитель 
ролик: Ролик 
сёрфинг: Серфинг 
артета: Артета 
наполнять: наполняет 
хвататься: хватаешься 
благодарность: благодарности 
полулегкий: полулегкий 
поправить: поправили 
малышев: Малышев 
медицина: Медицина 
видение: видение 
окончательный: Окончательный окончательного 
кампания: кампании 
кертис: Кертис 
фанат: фанатов 
бест: Бесте 
йоксимовича: Йоксимовича 
среди: среди 
бенфика: Бенфика 
стоять: стоял 
прожить: прожили 
бундеслига: бундеслиге Бундеслига 
якупов: Якупов 
оговорить: оговорили 
краснодарский: Краснодарском Краснодарского 
латвийский: Латвийская 
вильярреал: Вильярреал 
устный: устной 
зимой: зимой 
маркос: Маркос 
ссора: ссоры 
отставание: отставанием 
фиба: ФИБА 
нгонге: Нгонге 
погибнуть: погиб 
айрес: Айресе 
восточный: Восточная Восточной 
хабиб: Хабиб Хабиба 
триппьер: Триппьер 
алина: Алина 
грань: грани 
рс: РС 
мысль: мысль 
член: членов 
универсальный: Универсальные 
турция: Турция 
дополнительный: дополнительных 
сдать: сдать сдали 
издаваться: Издается 
подстраховать: подстраховать 
звать: зовут 
патриот: патриоты 
частица: частицу 
портал: Портал 
ситуация: ситуацию 
пьедестал: пьедестал 
каждый: каждый 
перечислить: перечислила 
рост: рост 
длинный: длинные 
деян: Деян 
сноуборд: Сноуборд 
успенский: Успенский 
получение: получении 
течение: течение 
беллингем: Беллингем 
сентябрь: сентября 
шарф: шарфами 
натан: Натану 
спороть: спорю 
трансгендеров: трансгендеров 
хотя: Хотя 
эндокринолог: Эндокринолог 
машук: Машуков 
ожидание: ожиданий 
бег: бега 
что: чему 
роднина: Роднина 
ху: Ху 
официально: Официально 
одиннадцатый: одиннадцатая 
уилкшир: Уилкшир 
столарз: Столарз 
марина: Марина 
удар: удар 
ярославский: ярославской 
глеб: Глеб 
слушание: слушания 
антуан: Антуан 
рассматривать: рассматривали рассматривал 
от: ото 
чувство: чувство 
любой: любому 
операция: операцию 
оба: обе 
обеспечение: обеспечению 
противоположный: противоположный 
людмила: Людмила 
жеребьёвка: жеребьевка 
дважды: дважды 
специя: Специя 
ярость: ярости 
богатый: богатые 
штаб: штаба штабе 
двор: дворе 
ндиайе: Ндиайе 
мадридский: мадридский 
поделиться: поделился поделилась 
фернандешу: Фернандешу 
ларионов: Ларионов 
высказаться: высказался высказалась 
старый: Стар старые 
тихоокеанский: Тихоокеанский 
связь: связь связи 
приём: приемы 
впервые: впервые 
сохранять: сохраняет 
алдан: Алдана 
скаут: скаутом 
мембрана: мембранах 
сообщать: сообщает 
советский: советский 
гранд: Гранд 
копенгаген: Копенгагеном Копенгаген 
популярность: популярность 
убежище: убежище 
джоковича: Джоковича 
условие: условия 
тагил: Тагил 
вино: вина 
пицца: пицца 
барак: Барак 
виролайнен: Виролайнен 
калифорния: Калифорния 
атмосфера: атмосферу 
успешный: успешный 
вступление: вступление 
трибуна: трибун 
кварацхелией: Кварацхелией 
биатлонистка: биатлонистка 
выполнять: выполняет 
ум: ума 
нюанс: нюансы 
жажда: жажды 
сочувствовать: Сочувствующий 
ротор: Ротор 
айман: Айман 
мюнхенец: мюнхенцев 
разочаровать: разочарует 
очень: очень Очень 
пиво: пиво 
стоить: стоило 
написать: напишите 
подтвердить: подтвердили 
объём: объеме 
мунис: Мунис 
порох: порох 
артеты: Артеты 
оценивать: оценивает 
гагарин: Гагарина 
суператлетов: суператлетов 
гудасич: Гудасич 
приблизительно: приблизительно 
джек: Джек 
холанн: Холанн 
комментарий: комментарий комментариях 
приложение: приложении 
отрабатывать: отрабатывали 
раскатка: раскатке 
магазин: магазины 
отчасти: отчасти 
рыцарь: рыцарем 
рекордный: рекордные 
талантливый: талантливая 
феттель: Феттеля 
тематический: тематических 
тромб: тромбы 
рутина: рутину 
вспоминать: вспоминает 
китайский: китайский 
шанхай: Шанхай 
переломный: переломный 
малайзия: Малайзия 
нигерия: Нигерия 
драчёв: Драчев 
исполком: Исполком 
оторваться: оторвался 
красиво: красиво 
оценка: оценки 
отличаться: отличаться отличается 
ух: Ух 
качаться: качается 
пугачёв: Пугачеву 
колыванов: Колыванов 
никак: никак 
постекоглу: Постекоглу 
рейс: рейсом 
оштрафовать: оштрафован 
мба: МБА 
смена: смены 
украина: Украина Украины 
долго: долго 
бренд: Бренд 
вероятность: вероятность 
загреб: Загреба 
хаб: Хаб 
бухарест: Бухаресте 
повториться: повторюсь 
звание: звание 
пойти: пойдет 
бегать: бегать бегаю 
роман: Романом 
сталкиваться: сталкиваются 
ливрея: Ливрея 
сбежать: сбежать 
чумич: Чумич 
петрович: Петрович 
залог: залог 
непривычно: непривычно 
будапешт: Будапеште 
эл: ЭЛ 
форсировать: форсировать 
зал: зале 
отсчитываться: отсчитывается 
погода: Погода 
англичанин: Англичанин 
букин: Букин 
кр: Кр 
циклон: Циклон циклон 
наверное: Наверное наверное 
ходить: ходили 
новосибирск: Новосибирске 
утопить: утопить 
заир: Заиром 
анастасия: Анастасия 
ролан: Ролан 
ограбить: ограбили 
северный: северных 
сдаться: сдалась 
публикация: публикации 
крылов: Крылов 
слишком: слишком 
котироваться: котируется 
эмоция: эмоциями 
выбить: выбили 
помешать: помешало 
увлечение: Увлечения 
плюшевый: плюшевая 
путешествие: Путешествия 
взнос: взнос 
отказывать: отказывал 
настаивать: настаивает 
григор: Григора Григор 
лайна: лайн 
милохина: Милохина 
легко: легко 
поспорить: поспорил 
пересмотреть: пересмотрел 
вспомнить: вспомнил 
гусев: Гусев 
джеймс: Джеймс 
союз: союз Союза 
настольный: Настольный 
игнорировать: игнорировать 
аманда: Аманда 
серб: Серб 
окно: Окон 
двоюродный: двоюродному 
хэм: Хэм 
разрешить: разрешить 
вступить: вступил 
путь: Путь 
государственный: Государственное 
шедевр: шедевр 
обида: обиды 
нн: НН 
осень: Осень 
василий: Василий 
червоткин: Червоткин 
минеев: Минеев 
въезд: въезде 
вердикт: вердикту 
федеральный: федеральное 
заканчиваться: заканчивается 
месть: Месть 
недоступный: недоступны 
скалолазание: Скалолазание 
математика: математику 
нба: НБА 
питание: питания 
ивичем: Ивичем 
денисов: Денисов 
внести: внести 
биодобавок: биодобавок 
родина: Родину Родины Родина 
мильштейн: Мильштейна 
алексеев: Алексеев 
рублёв: Рублев 
художественный: Художественная 
проводить: проводит проводил 
хоус: Хоус 
ерёмин: Еремин 
сообщение: сообщении 
номинант: номинантов 
окончание: окончании 
стоимость: стоимость 
саня: Саня 
аджмал: Аджмала 
оспорить: оспорила 
юлаев: Юлаев 
рейнджерс: Рейнджерс 
айлендерс: Айлендерс 
жарко: жарко 
наталья: Наталья 
хоув: Хоув 
салах: Салаха 
жамал: Жамалов 
пивоваров: Пивоварова 
возможность: возможность 
плишкова: Плишкова 
признаться: признался 
сан: Сан 
вхл: ВХЛ 
заметить: заметили 
фут: Фут 
перезарядиться: перезарядились 
помощь: помощью 
драка: драку 
лукич: Лукич 
мэдли: Мэдли 
босой: Бос 
астан: Астану 
герл: герл 
концертный: концертном 
эйса: эйса 
громить: громят 
поднимать: поднимает 
бонус: бонус 
сильвия: Сильвия 
впасть: впал 
бобслеист: Бобслеист бобслеист 
протекать: протекает 
исключение: исключение 
способный: способен способная 
реализация: реализация 
эль: Эль 
цзю: Цзю 
настигать: настигает 
теннисист: теннисист 
танцевальный: Танцевальный 
показатель: показателе 
тулуза: Тулуза 
решающий: решающими 
рома: Рома 
торино: Торино 
симонса: Симонса 
указать: указан 
фролов: Фролова 
затем: затем 
передавать: передает 
раскритиковать: раскритиковал 
минимальный: минимальный 
объект: объектов 
галузин: Галузин 
халиль: Халили 
обамеянг: Обамеянг 
стараться: старалась 
травкин: Травкин 
отлично: отлично 
восхищаться: восхищаются 
отдельный: отдельных 
устно: устно 
прощение: прощения 
вносить: вносил 
рука: руку 
томас: Томас 
политика: политики 
риибер: Риибер 
автоспорт: Автоспорт 
самонов: Самонов 
бол: бол 
голышак: Голышак 
дебютный: дебютном 
потратить: потратить 
снятие: снятия 
хайповый: Хайповый 
сенсация: сенсацией 
вручить: вручили 
лыжа: лыжах 
двойка: двоек 
уиттакер: Уиттакер 
партизан: Партизан 
леонов: Леонова 
апл: АПЛ 
религия: религия 
африка: Африки 
боруссия: Боруссия 
некрасиво: некрасиво 
прислушиваться: прислушиваемся 
чмыхов: Чмыхов 
ухудшать: ухудшает 
ради: ради 
берёзкин: Березкин 
финляндия: Финляндии 
толчок: толчок 
фурсова: Фурсова 
футболка: футболка 
пересчёт: пересчета 
прийтись: придется 
занятие: занятиях 
родиться: родится 
нью: Нью 
минаков: Минаков 
подать: подала 
немков: Немков 
мужчина: мужчин Мужчины 
алискер: Алискеров 
голкипер: Голкипер 
необходимо: необходимо 
верный: верным 
утверждать: утверждает 
совершить: совершит 
милохин: Милохин 
нежно: нежно 
любитель: любителей 
выкатываться: выкатываться 
дайвинг: Дайвинг 
джексон: Джексон 
джастин: Джастин 
снайпер: Снайперы 
лёша: Леша 
индонезия: Индонезия 
продолжиться: продолжится 
часть: часть 
ранить: ранили 
королевский: Королевские 
близко: близко 
симон: Симон 
оспаривать: оспаривать 
молодёжь: молодежь 
френдруп: Френдруп 
одеться: оделся 
семён: Семен 
возникнуть: возникли 
зависеть: зависеть 
топовый: топовый 
магнуссон: Магнуссон 
справедливо: справедливо 
дж: Дж 
заслуженно: заслуженно 
надежда: Надежда 
рияде: Рияде 
снежана: Снежана 
потушить: потушит 
вертолётчик: вертолетчиком 
заставить: Заставить 
апрель: апреле 
невезение: невезения 
профессионально: профессионально 
микеля: Микеля 
уехать: уехать 
планироваться: планируется 
витесса: Витесса 
гарре: Гарре 
урок: УРОК 
игумнов: Игумнов 
железнодорожник: железнодорожниками 
маррэй: Маррэй 
рфб: РФБ 
мультфильм: Мультфильмы 
передряга: передряги 
рубин: Рубином 
красивый: красивые 
бо: Бо 
владислав: Владислав 
шутка: шутка 
порядин: Порядин 
выплеск: выплеск 
горе: горем 
гвардиола: Гвардиола 
предсезонка: предсезонка 
японец: Японец 
